orthographe	phonetique
les	le
le	l@
un	I
une	yn
dans	dA
homme	Om
femme	fam
femmes	fam
beau	bo
beaux	bo
est	e
est	E
et	e
fait	fE
fait	fe
sent	sA
cent	sA
sans	sA
gâteau	gato
gâteaux	gato
Pyrénées	piRene
vent	vA
vend	vA
voyage	vojaZ
voyagent	vojaZ
